WWWWWWWWWWWWWWWWWWWWWWWWWWWW
WCCCCCCWWCCCCCCCCCCWWCCCCCCW
WCWWWWCWWCWWWWWWWWCWWCWWWWCW
WCWWWWCWWCWWWWWWWWCWWCWWWWCW
WCWWCCCCCCCCCWWCCCCCCCCCWWCW
WCWWCWWWWCWWCWWCWWCWWWWCWWCW
WCWWCWWWWCWWCWWCWWCWWWWCWWCW
WCWWCWWWWCWWCWWCWWCWWWWCWWCW
WCCCCCCCCCWWCCCCWWCCCCC1CCCW
WCWWWWCWWCWWWWWWWWCWWCWWWWCW
WCWWWWCWWCWWWWWWWWCWWCWWWWCW
WCCCCCCWWCCCCCCCCCCWWCCCCCCW
WCWWCWWWWCWWWBBWWWCWWWWCWWCW
WCWWCWWWWCWCCCCCCWCWWWWCWWCW
WCWWCCCCCCWCCCCCCWCCCCCCWWCW
WCWWWWCWWCWCCCCCCWCWWCWWWWCW
WCWWWWCWWCWWWWWWWWCWWCWWWWCW
WCCCCCCWWCCCCCCCCCCWWCCCCCCW
WCWWCWWWWWWWCWWCWWWWWWWCWWCW
WCWWCWWWWWWWCWWCWWWWWWWCWWCW
WCWWCCCCCCCCCWWCCCCCCCCCWWCW
WCWWWWWWWCWWWWWWWWCWWWWWWWCW
WCWWWWWWWCWWWWWWWWCWWWWWWWCW
WCCCCCCCCCCCCCCCCCCCCCCCCCCW
WCWWWWCWWCWWWWWWWWCWWCWWWWCW
WCWWWWCWWCWWWWWWWWCWWCWWWWCW
WCWWCCCWWCWWCCCCWWCWWCCCWWCW
WCWWCWWWWCWWCWWCWWCWWWWCWWCW
WCWWCWWWWCWWCWWCWWCWWWWCWWCW
WCCCCCCCCCCCPWWCCCCCCCCCCCCW
WWWWWWWWWWWWWWWWWWWWWWWWWWWW